wwwwwwwwwwwwwwwww
w     w   w     w
w     w   w    gw
w              ww
w c w   w   w   w
w   w   w   w   w
wwwwwwwwwwwwwwwww