wwwwwwwwww
w        w
wc  wwwwww
ww  w   ww
ww  w  g w
ww  w  www
ww     w w
ww     w w
wwwwwwwwww