wwwwwww
w     w
w     w
w     w
w     w
w     w
w c   w
w    gw
wwwwwww