wwwwwww
w     w
w     w
w     w
w     w
w     w
w c  gw
w    ww
wwwwwww