wwwwwwwwww
w        w
w        w
w       gw
w       ww
w       ww
ww  c   ww
w       ww
wwwwwwwwww