wwwwwwwwwwwwwwww
w              w
w              w
w              w
w              w
w             gw
w c w         ww
w   w         ww
wwwwwwwwwwwwwwww