wwwwwwwwwwwww
w           w
w           w
w          gw
w          ww
w          ww
w c w      ww
w   w      ww
wwwwwwwwwwwww