wwwwwww
w     w
w     w
w     w
w     w
w    gw
w c  ww
w    ww
wwwwwww