wwwwwwwwwwww
w    w     w
w    w    gw
w    w    ww
w    w    ww
w    w    ww
w c       ww
w         ww
wwwwwwwwwwww